NO ./maps/north.xpm
SO ./maps/south.xpm
WE ./maps/west.xpm
EA ./maps/east.xpm

F 0,255,0
C 0,255,0


111111111111111111111111
1111111111111111111111111
1000000000110000000000001
1011000001110000000000001
10010000000000000N0000001
1111111111111111111111111