





































;;;;







F 255,255,0
























NO ./maps/south.xpm






SO ./maps/north.xpm









C                         0,255,255























WE         ./maps/south.xpm



























EA ./maps/east.xpm










11111111111111111













































































































                                    1                   11                  1111
            1111
            10011
            1101
11111111111111011111111
1111111111110001111111111111111
1000000000110000000000000000 1
1011000001110000000000000000111
111111110000000000000000111111
10010000000000000S0000001
1111111111111111101111111
111111111111111111
111111111111111011111111111111111111111111111111111111111111111111111111111111111111111111111111111111111111111111111111
111111111111111111111111111111111111111111111
1
1
                    1
                         1111                                                                                                                                   1