
























































F 255,255,0




























NO ./maps/north.xpm






SO ./maps/south.xpm









C                         0,255,255























WE         ./maps/south.xpm




























EA ./maps/east.xpm























































































































                                    1                   11                  1111
            1111
            10011
            1101
11111111111111011111111
1111111111110001111111111
1000000000110000000000001
1011000001110000000000001
11111111000000000000000011
10010000000000000N0000001

1111111111111111111111111
11111111111111111
111111111111111011111111111111111111111111111111111111111111111111111111111111111111111111111111111111111111111111111111
111111111111111111111111111111111111111111111
1
1
                    1
                         1111                                                                                                                                   1
