






























































F 255,255,0




























NO ./maps/north.xpm






SO ./maps/south.xpm

























C 0,255,255




























WE ./maps/south.xpm





























EA ./maps/east.xpm




















































1111111111111111111111111111111111111111111111111111111111111111111111111111111111111
11111111111111111111111
1111111111110111111111111
1000000000110000000000001
1011000001110000000000001
10010000000000000N0000001
1111111111111111111111111
111111111111111011111111111111111111111111111111111111111111111111111111111111111111111111111111111111111111111111111111
111111111111111111111111111111111111111111111