NO ./maps/mec.xpm
SO ./maps/meuf.xpm
WE ./maps/minion.xpm
EA ./maps/east.xpm

F 1,00,000
C 0,255,0

1111111111111111111111111
1000000000110000000000001
1011000001110000000000W01
1001000000000000000000001
1111111111110111111111111
           101
           101
           101
           101
           101
        1111011111
        1000000001
        1001111001
        1001111001
        1001111101
        1001111111
        100111111
        10111
        100111
        110001
        1110111
        11001111
        1000111
    11110001111
    111000111
    1000111
    100111
    1001
    1111