NO ./maps/north.xpm
SO ./maps/south.xpm
WE ./maps/west.xpm
EA ./maps/east.xpm

F 220,100,0
C 225,30,0

11111
11001
11N01
10001
11111