NO ./maps/north.xpm
SO ./maps/south.xpm
WE ./maps/west.xpm
EA ./maps/east.xpm

F 220,100,0
C 225,30,0

11111111111111
10100000000001
10000000000101
10100000000001
10000000000101
10100000000001
100000N0000101
10100000000001
10000000000101
10100000000001
10000000000101
10100000000001
11111111111111
