NO ./maps/minion.xpm
SO ./maps/mec.xpm
WE ./maps/meuf.xpm
EA ./maps/east.xpm

F          0,0,0
C          0,255,0

11111111111111
10100000000001
10000000000101
10100000000001
10000000000101
10100000000101
10000000N00011
10100000000101
10000000000101
10100000000001
10000000000101
10100000000001
11111100000111
  1111000001
  1111111111