NO ./maps/north.xpm
SO ./maps/south.xpm
WE ./maps/west.xpm
EA ./maps/east.xpm

F 220,100,0
C 225,30,0

111111
100101
100001
100N01
100101
111111