NO ./maps/minion.xpm
SO ./maps/south.xpm
WE ./maps/west.xpm
EA ./maps/east.xpm

F 220,100,0
C 225,30,0

11111111111111
10100000000001
10000000000101
10100000000001
10000000000101
10100100000101
10000100N00011
10100100000101
10000100000101
10100000000001
10000000000101
10100000000001
11111100000111
11111100000111
11111100000111
11111100000111
11111100000111
    111111111
